#########################
#           #           #
#    #### ###   ####### #
#    #  # #   ###     # #
#  ###  ###   #   ### # #
#  #        ###   # ### #
#                 #     #
#########################