#########################
#     #     #     #     #
#     #     #     #     #
#                       #
#                       #
#     #     #     #     #
#     #     #     #     #
#########################