###################
#                 #
#                 #
#        ##       #
#        ##       #
#        ##       #
#        ##       #
###################