################
#              #
#              #
#     ###      #
#     #####    #
#              #
################