############################
#                          #
#                          #
#              #############
#              #
#              #
################
